{
  "levels":[
    {
      "tiles":[
        [1, 1, 1, 1, 1, 1, 1,1],
        [1, 9, 1, 0, 0, 0, 0,1],
        [1, 0, 1, 0, 1, 0, 4,1],
        [1, 0, 1, 0, 1, 0, 0,1],
        [1, 0, 1, 0, 1, 0, 4,1],
        [1, 0, 0, 0, 1, 0, 0,4],
        [1, 1, 1, 1, 1, 1, 1, 1]
      ]
    },
    {
      "tiles":[
        [1, 1, 1, 1, 1, 1, 1],
        [1, 9, 1, 0, 0, 0, 1],
        [1, 2, 1, 0, 1, 0, 1],
        [1, 5, 1, 0, 1, 0, 1],
        [1, 2, 1, 0, 1, 0, 1],
        [1, 5, 0, 0, 1, 0, 4],
        [1, 1, 1, 1, 1, 1, 1]
      ]
    },
    {
      "tiles":[
        [1, 1, 1, 1, 1, 1, 1, 1, 1, 1, 1],
        [1, 0, 1, 0, 0, 0, 0, 0, 0, 0, 1],
        [1, 0, 1, 0, 1, 0, 0, 73, 9, 0, 1],
        [1, 0, 1, 0, 1, 0, 0, 0, 0, 0, 1],
        [1, 0, 1, 0, 1, 0, 0, 0, 0, 2, 1],
        [4, 0, 5, 0, 1, 0, 0, 0, 0, 0, 1],
        [1, 1, 1, 1, 1, 1, 1, 1, 1, 1, 1]
      ]
    },
    {
      "tiles":[
        [1, 1, 1, 1, 1, 1, 1, 1, 1, 1, 1],
        [1, 0, 1, 0, 0, 0, 0, 0, 0, 0, 1],
        [1, 0, 1, 0, 1, 0, 0, 0, 9, 0, 1],
        [1, 0, 1, 0, 1, 0, 0, 0, 0, 0, 1],
        [1, 0, 1, 0, 1, 0, 0, 0, 0, 2, 1],
        [4, 0, 5, 0, 1, "e", 73, "e", 0, 0, 1],
        [1, 1, 1, 1, 1, 1, 1, 1, 1, 1, 1]
      ]
    }

    ]
}